{
	"tile_width":  16,
	"tile_height": 16,

	"width":  15,
	"height": 13,

	"block":[
		[1, 1, 1, 1, 1, 1, 1, 1, 1, 1, 1, 1, 1, 1, 1],
		[1, 1, 1, 1, 1, 1, 1, 1, 1, 1, 1, 1, 1, 1, 1],
		[1, 1, 1, 0, 0, 0, 0, 0, 0, 0, 0, 0, 1, 1, 1],
		[1, 1, 1, 0, 1, 0, 1, 0, 1, 0, 1, 0, 1, 1, 1],
		[1, 1, 1, 0, 0, 0, 0, 0, 0, 0, 0, 0, 1, 1, 1],
		[1, 1, 1, 0, 1, 0, 1, 0, 1, 0, 1, 0, 1, 1, 1],
		[1, 1, 1, 0, 0, 0, 0, 0, 0, 0, 0, 0, 1, 1, 1],
		[1, 1, 1, 0, 1, 0, 1, 0, 1, 0, 1, 0, 1, 1, 1],
		[1, 1, 1, 0, 0, 0, 0, 0, 0, 0, 0, 0, 1, 1, 1],
		[1, 1, 1, 0, 1, 0, 1, 0, 1, 0, 1, 0, 1, 1, 1],
		[1, 1, 1, 0, 0, 0, 0, 0, 0, 0, 0, 0, 1, 1, 1],
		[1, 1, 1, 1, 1, 1, 1, 1, 1, 1, 1, 1, 1, 1, 1],
		[1, 1, 1, 1, 1, 1, 1, 1, 1, 1, 1, 1, 1, 1, 1]
	],

	"spritesheet": "res/stage0/sheet.png",
	"texture":[
		[3, 3, 3, 3, 3, 3, 3, 3, 3, 3, 3, 3, 3, 3, 3],
		[3, 3, 2, 2, 2, 2, 2, 2, 2, 2, 2, 2, 2, 3, 3],
		[3, 3, 2, 0, 0, 0, 0, 0, 0, 0, 0, 0, 2, 3, 3],
		[3, 3, 2, 0, 1, 0, 1, 0, 1, 0, 1, 0, 2, 3, 3],
		[3, 3, 2, 0, 0, 0, 0, 0, 0, 0, 0, 0, 2, 3, 3],
		[3, 3, 2, 0, 1, 0, 1, 0, 1, 0, 1, 0, 2, 3, 3],
		[3, 3, 2, 0, 0, 0, 0, 0, 0, 0, 0, 0, 2, 3, 3],
		[3, 3, 2, 0, 1, 0, 1, 0, 1, 0, 1, 0, 2, 3, 3],
		[3, 3, 2, 0, 0, 0, 0, 0, 0, 0, 0, 0, 2, 3, 3],
		[3, 3, 2, 0, 1, 0, 1, 0, 1, 0, 1, 0, 2, 3, 3],
		[3, 3, 2, 0, 0, 0, 0, 0, 0, 0, 0, 0, 2, 3, 3],
		[3, 3, 2, 2, 2, 2, 2, 2, 2, 2, 2, 2, 2, 3, 3],
		[3, 3, 3, 3, 3, 3, 3, 3, 3, 3, 3, 3, 3, 3, 3]
	]
}
