{
    "tile_width":  32,
    "tile_height": 32,

    "width":  7,
    "height": 7,

    "images":[
        "res/dummy0/wall.png",
        "res/dummy0/ground.png",
        "res/dummy0/blockage.png"
    ],

    "blocks":[
        [1, 1, 1, 1, 1, 1, 1],
        [1, 0, 0, 0, 0, 0, 1],
        [1, 0, 1, 0, 1, 0, 1],
        [1, 0, 0, 0, 0, 0, 1],
        [1, 0, 1, 0, 1, 0, 1],
        [1, 0, 0, 0, 0, 0, 1],
        [1, 1, 1, 1, 1, 1, 1],
    ],
    "texture":[
        [0, 0, 0, 0, 0, 0, 0],
        [0, 1, 1, 1, 1, 1, 0],
        [0, 1, 2, 1, 2, 1, 0],
        [0, 1, 1, 1, 1, 1, 0],
        [0, 1, 2, 1, 2, 1, 0],
        [0, 1, 1, 1, 1, 1, 0],
        [0, 0, 0, 0, 0, 0, 0],
    ]
}
